NO texture/wall.xpm
SO texture/wall2.xpm
WE texture/wall3.xpm
EA texture/wall4.xpm

F 153,76,0
C 153,204,255




        1111111111111111111111111
        1000100000110000000000001
        1011000001110000000000001
        1001000000000000000000001
111111111011000001110000000000001
100000000000000001110111100011111
11110111111111011100000010001
11110111111111011101010010001
11000001101010111000000100001
10000010000000001100000010001
10000000000000001101010010001
111N0000010101111101111000111
1111011111110101 101111010001
11111111 1111111 111111111111