NO texture/jib.xpm
SO sprites/face.xpm
WE sprites/face.xpm
EA sprites/face.xpm

F 220,100,0
C 225,30,0

111111111111
100020200001
100000000001
100000000001
10000N000001
120000000001
100000000001
120002000001
100000000001
100000000001
100000000001
100000000001
111111111111