NO texture/drunk/jib.xpm
SO sprites/face.xpm

EA sprites/title/sub_title.xpm

F 120,160,10
C 225,30,0

WE texture/wall.xpm

111111111111
100010110001
100000000001
100000000001
10000E000001
110000000011
100000000001
100011000001
100000000001
100000000001
100000000001
100000000001
111111111111