NO ./texture/amongus.xpm
SO ./texture/amongus.xpm
WE ./texture/jib.xpm
EA ./texture/jib.xpm

F 97,247,67
C 235,115,115

        111111
        100001
        100001
        100001
        100001
        100001
        100001
        100001
  111111100001111111
 110000000S0000000011
1110000000000000000111
 11000001111100000011
  111111     1111111